{8, 8, 8, 8, 2, 2, 2, 2, 2, 8, 8, 8, 8, 8, 8, 8, 8, 8, 8},
{8, 8, 8, 8, 2, 0, 0, 0, 2, 8, 8, 8, 8, 8, 8, 8, 8, 8, 8},
{8, 8, 8, 8, 2, 0, 0, 0, 2, 8, 8, 8, 8, 8, 8, 8, 8, 8, 8},
{8, 8, 2, 2, 2, 0, 2, 3, 2, 2, 8, 8, 8, 8, 8, 8, 8, 8, 8},
{8, 8, 2, 0, 0, 0, 0, 0, 0, 2, 8, 8, 8, 8, 8, 8, 8, 8, 8},
{2, 2, 2, 0, 2, 3, 2, 2, 0, 2, 8, 8, 8, 2, 2, 2, 2, 2, 2},
{2, 0, 0, 0, 2, 0, 2, 2, 0, 2, 2, 2, 2, 2, 0, 0, 0, 4, 2},
{2, 0, 3, 0, 0, 0, 3, 0, 0, 0, 0, 0, 0, 0, 0, 0, 4, 4, 2},
{2, 2, 2, 2, 2, 0, 2, 2, 2, 0, 2, 1, 2, 2, 0, 0, 0, 4, 2},
{8, 8, 8, 8, 2, 0, 0, 0, 0, 0, 2, 2, 2, 2, 2, 2, 2, 2, 2},
{8, 8, 8, 8, 2, 2, 2, 2, 2, 2, 2, 8, 8, 8, 8, 8, 8, 8, 8}
